
    F                   22,55,6



NO       ./texture/texture22.xpm    

         SO    ./texture/texture22.xpm

         WE./texture/texture23.xpm

EA ./texture/texture23.xpm

C 6,5,255

1111111111111111111111111
1000S00000110000000000001
1011000001110000000000001
1001000000000000000000001
11111111101100000111000001111111
100000000011000001110111111111111
11110111111111010000000010001
11110111111111011101010010001
11001000110101011100000000001
10000000000000000000000010001
10000000000000001101010010001
1100000111010101111101111000111
11110111 1110101 101111010001
11111111 1111111 111111111111
