
C 63,0,39

    F                   22,55,6   

NO

         SU

EA
         WE


111111111111111111111111111
111011000001110000000000001
11110000001100000111011111111
11110111111111011100000010001
11110111111111011101010010001
11000000110101011100000010001
10000000000000001100000010001
1000100000000001101010010001
11001011101010111110111100N1
1111111111111111111111111111