
    F                   22,55,6



NO       ./test.xpm    

         SO    ./test.xpm

         WE./test.xpm

EA ./test.xpm

C 6,5,255

11111111111111111111111
10000000000000000000001
10000000000000000000001
10000000000000000000001
10000000000000000000001
10000000000000000000001
10000000000000000000001
10000000000000000S00001
10000000000000000000001
10000000000000000000001
11111111111111111111111