
C 6,5,5

    F                   22,55,6



NO       ./test.xpm    

         SO    ./test.xpm

         WE./test.xpm
EA ./test.xpm



11111111        
111011000001110000000000001
111100000011000001110111111111111111
1111011111111101110000001
11001011101010111110111100N1
1111111111111111111111111111