
    F                   31,19,0

NO       ./texture/wall5.xpm    

         SO    ./texture/wall5.xpm

         WE./texture/wall4.xpm

EA ./texture/wall4.xpm

C 26,21,40

1111111111111111111111111
1000000000110000000000001
1011000001110000000000001
100100000000000000000000111111111
111111111011000001110000000000001
10000E000011000001110111111111111
11110111111111010000000010001
11110111111111011101010010001
11001000110101011100000000001
10000000000000000000000010001
10000000000000001101010010001
1100000111010101111101111000111
11110111 1110101 101111010001
11111111 1111111 111111111111
