C 06,5,255
F 21,55,6
NO ./texture/texture1.xpm
SO ./texture/texture4.xpm
WE ./texture/texture5.xpm
EA ./texture/texture6.xpm

111111111111111
100000000000001
101111011111101
101001010000101
101101010111101
101101010100001
101101011111101
101000010000101
111011111011101
100010000010001
101111011011111
100000010000001
111101111101111
10000000000N001
111111111111111