C 06,5,255
F 21,55,6
NO ./texture/texture18.xpm
SO ./texture/texture40.xpm
WE ./texture/texture35.xpm
EA ./texture/texture26.xpm


    1
   101
  10001
 1000001
1000N0001
111111111